"CA","TX","WI","Total","date","event_type","snap_CA","snap_TX","snap_WI"
11047,7381,6984,25412,2011-02-01,NA,1,1,0
9925,5912,3309,19146,2011-02-02,NA,1,0,1
11322,9006,8883,29211,2011-02-03,NA,1,1,1
12251,6226,9533,28010,2011-02-04,NA,1,0,0
16610,9440,11882,37932,2011-02-05,NA,1,1,1
14696,9376,8664,32736,2011-02-06,"Sporting",1,1,1
11822,7319,6431,25572,2011-02-07,NA,1,1,0
10933,6224,5914,23071,2011-02-08,NA,1,0,1
10350,6740,6568,23658,2011-02-09,NA,1,1,1
11204,6109,6443,23756,2011-02-10,NA,1,0,0
11354,7202,7889,26445,2011-02-11,NA,0,1,1
14610,10081,10142,34833,2011-02-12,NA,0,1,1
15630,11725,9025,36380,2011-02-13,NA,0,1,0
9044,6719,6041,21804,2011-02-14,"Cultural",0,0,1
9496,7460,7114,24070,2011-02-15,NA,0,1,1
8844,6606,5993,21443,2011-02-16,NA,0,0,0
7835,6412,6071,20318,2011-02-17,NA,0,0,0
10025,6711,6985,23721,2011-02-18,NA,0,0,0
13870,9150,8669,31689,2011-02-19,NA,0,0,0
13465,9789,6029,29283,2011-02-20,NA,0,0,0
11997,7297,4672,23966,2011-02-21,"National",0,0,0
9130,6628,4743,20501,2011-02-22,NA,0,0,0
8941,5814,6002,20757,2011-02-23,NA,0,0,0
8514,6175,5588,20277,2011-02-24,NA,0,0,0
9847,6286,6396,22529,2011-02-25,NA,0,0,0
13652,8586,7670,29908,2011-02-26,NA,0,0,0
12491,9086,7130,28707,2011-02-27,NA,0,0,0
9196,6555,5489,21240,2011-02-28,NA,0,0,0
9782,7082,6008,22872,2011-03-01,NA,1,1,0
9537,6145,6364,22046,2011-03-02,NA,1,0,1
9710,6639,7126,23475,2011-03-03,NA,1,1,1
10444,6584,6544,23572,2011-03-04,NA,1,0,0
13784,9238,8180,31202,2011-03-05,NA,1,1,1
16057,10423,8396,34876,2011-03-06,NA,1,1,1
10953,7623,5986,24562,2011-03-07,NA,1,1,0
10299,6335,6118,22752,2011-03-08,NA,1,0,1
9951,6941,5668,22560,2011-03-09,"Religious",1,1,1
10012,6339,6275,22626,2011-03-10,NA,1,0,0
11189,7203,7180,25572,2011-03-11,NA,0,1,1
13710,9271,9244,32225,2011-03-12,NA,0,1,1
14340,9542,7535,31417,2011-03-13,NA,0,1,0
10722,7745,6468,24935,2011-03-14,NA,0,0,1
9293,7834,6894,24021,2011-03-15,NA,0,1,1
9752,6768,6245,22765,2011-03-16,"Religious",0,0,0
9504,6759,5516,21779,2011-03-17,"Cultural",0,0,0
10030,7131,6694,23855,2011-03-18,NA,0,0,0
14509,8203,7887,30599,2011-03-19,NA,0,0,0
14112,8992,6539,29643,2011-03-20,"Religious",0,0,0
10255,7075,5771,23101,2011-03-21,NA,0,0,0
9383,6086,5023,20492,2011-03-22,NA,0,0,0
8490,5914,4826,19230,2011-03-23,NA,0,0,0
7889,5898,5067,18854,2011-03-24,NA,0,0,0
11011,6249,6090,23350,2011-03-25,NA,0,0,0
13816,8072,7732,29620,2011-03-26,NA,0,0,0
13661,9434,6771,29866,2011-03-27,NA,0,0,0
9997,6429,5023,21449,2011-03-28,NA,0,0,0
8516,5728,5337,19581,2011-03-29,NA,0,0,0
8911,5384,4633,18928,2011-03-30,NA,0,0,0
10059,6096,5587,21742,2011-03-31,NA,0,0,0
12827,7992,7490,28309,2011-04-01,NA,1,1,0
14791,9134,9553,33478,2011-04-02,NA,1,0,1
15341,9863,7854,33058,2011-04-03,NA,1,1,1
12356,6648,5848,24852,2011-04-04,NA,1,0,0
10497,6743,6341,23581,2011-04-05,NA,1,1,1
10101,6689,5866,22656,2011-04-06,NA,1,1,1
10575,7201,5125,22901,2011-04-07,NA,1,1,0
10971,6797,6986,24754,2011-04-08,NA,1,0,1
14064,9025,8656,31745,2011-04-09,NA,1,1,1
15291,9648,6597,31536,2011-04-10,NA,1,0,0
11098,7555,6176,24829,2011-04-11,NA,0,1,1
9181,7302,6735,23218,2011-04-12,NA,0,1,1
8853,7202,5556,21611,2011-04-13,NA,0,1,0
9430,6338,6196,21964,2011-04-14,NA,0,0,1
10922,7749,6811,25482,2011-04-15,NA,0,1,1
12809,8573,7852,29234,2011-04-16,NA,0,0,0
13894,9248,6645,29787,2011-04-17,NA,0,0,0
9955,7218,5216,22389,2011-04-18,NA,0,0,0
8930,6133,4411,19474,2011-04-19,NA,0,0,0
8582,6387,5219,20188,2011-04-20,NA,0,0,0
8986,5677,5105,19768,2011-04-21,NA,0,0,0
10967,7542,5770,24279,2011-04-22,NA,0,0,0
13577,8833,7165,29575,2011-04-23,NA,0,0,0
11721,7897,4400,24018,2011-04-24,"Religious",0,0,0
8865,6339,4800,20004,2011-04-25,NA,0,0,0
8176,5535,4402,18113,2011-04-26,"Religious",0,0,0
8135,5369,4425,17929,2011-04-27,NA,0,0,0
7951,5372,4822,18145,2011-04-28,NA,0,0,0
9730,6432,6573,22735,2011-04-29,NA,0,0,0
12428,8240,7433,28101,2011-04-30,NA,0,0,0
12997,9644,6404,29045,2011-05-01,NA,1,1,0
10657,6125,6055,22837,2011-05-02,NA,1,0,1
10669,6937,6474,24080,2011-05-03,NA,1,1,1
9596,5771,5394,20761,2011-05-04,NA,1,0,0
9281,6372,5531,21184,2011-05-05,"Cultural",1,1,1
10617,7924,5945,24486,2011-05-06,NA,1,1,1
12386,8863,7163,28412,2011-05-07,NA,1,1,0
11231,7440,5017,23688,2011-05-08,"Cultural",1,0,1
11264,8001,5759,25024,2011-05-09,NA,1,1,1
10430,6523,5278,22231,2011-05-10,NA,1,0,0
9570,6755,5840,22165,2011-05-11,NA,0,1,1
9312,6708,6393,22413,2011-05-12,NA,0,1,1
10978,8231,6439,25648,2011-05-13,NA,0,1,0
12496,8663,7577,28736,2011-05-14,NA,0,0,1
13549,10237,7534,31320,2011-05-15,NA,0,1,1
9542,7141,5530,22213,2011-05-16,NA,0,0,0
8492,6179,4942,19613,2011-05-17,NA,0,0,0
8258,5787,4725,18770,2011-05-18,NA,0,0,0
8410,5680,4594,18684,2011-05-19,NA,0,0,0
9809,6337,5503,21649,2011-05-20,NA,0,0,0
12007,8288,6817,27112,2011-05-21,NA,0,0,0
12301,8518,5427,26246,2011-05-22,NA,0,0,0
9346,6545,5063,20954,2011-05-23,NA,0,0,0
8541,5813,4849,19203,2011-05-24,NA,0,0,0
8835,5958,4265,19058,2011-05-25,NA,0,0,0
9176,6283,5021,20480,2011-05-26,NA,0,0,0
10231,6343,5907,22481,2011-05-27,NA,0,0,0
10959,8286,6282,25527,2011-05-28,NA,0,0,0
11115,7251,5083,23449,2011-05-29,NA,0,0,0
10768,7152,4618,22538,2011-05-30,"National",0,0,0
8743,5865,4947,19555,2011-05-31,"Sporting",0,0,0
9662,7780,5723,23165,2011-06-01,NA,1,1,0
9889,6662,6130,22681,2011-06-02,NA,1,0,1
11788,8130,6863,26781,2011-06-03,NA,1,1,1
13730,8753,7827,30310,2011-06-04,NA,1,0,0
13997,9712,7895,31604,2011-06-05,NA,1,1,1
11171,8655,6859,26685,2011-06-06,NA,1,1,1
10489,7955,6645,25089,2011-06-07,NA,1,1,0
10606,7409,6438,24453,2011-06-08,NA,1,0,1
10266,7772,6744,24782,2011-06-09,NA,1,1,1
12188,7823,6408,26419,2011-06-10,NA,1,0,0
12534,9628,7778,29940,2011-06-11,NA,0,1,1
13616,10570,6908,31094,2011-06-12,"Sporting",0,1,1
11284,8731,5737,25752,2011-06-13,NA,0,1,0
10400,7320,6435,24155,2011-06-14,NA,0,0,1
10380,8142,6736,25258,2011-06-15,NA,0,1,1
9936,6941,5829,22706,2011-06-16,NA,0,0,0
10661,7876,6175,24712,2011-06-17,NA,0,0,0
12745,9080,7000,28825,2011-06-18,NA,0,0,0
11822,8521,5763,26106,2011-06-19,"Cultural",0,0,0
11173,7684,5404,24261,2011-06-20,NA,0,0,0
10049,6636,5125,21810,2011-06-21,NA,0,0,0
10125,5859,5417,21401,2011-06-22,NA,0,0,0
10442,7007,5331,22780,2011-06-23,NA,0,0,0
11207,7327,6104,24638,2011-06-24,NA,0,0,0
12037,8300,6145,26482,2011-06-25,NA,0,0,0
13032,9188,5448,27668,2011-06-26,NA,0,0,0
10458,7157,5027,22642,2011-06-27,NA,0,0,0
8483,6520,4797,19800,2011-06-28,NA,0,0,0
8956,6162,4812,19930,2011-06-29,NA,0,0,0
9822,6353,5276,21451,2011-06-30,NA,0,0,0
13455,9592,7986,31033,2011-07-01,NA,1,1,0
14988,9559,8454,33001,2011-07-02,NA,1,0,1
13502,9194,6477,29173,2011-07-03,NA,1,1,1
10583,7983,4467,23033,2011-07-04,"National",1,0,0
11916,8431,6249,26596,2011-07-05,NA,1,1,1
12365,7508,6729,26602,2011-07-06,NA,1,1,1
12070,8617,6040,26727,2011-07-07,NA,1,1,0
12505,7928,7246,27679,2011-07-08,NA,1,0,1
14046,10024,8416,32486,2011-07-09,NA,1,1,1
14520,9895,7124,31539,2011-07-10,NA,1,0,0
10926,8868,6798,26592,2011-07-11,NA,0,1,1
9697,7968,6967,24632,2011-07-12,NA,0,1,1
9553,8087,5805,23445,2011-07-13,NA,0,1,0
9800,7225,6422,23447,2011-07-14,NA,0,0,1
10931,8809,7609,27349,2011-07-15,NA,0,1,1
13438,9541,7890,30869,2011-07-16,NA,0,0,0
13484,9758,7092,30334,2011-07-17,NA,0,0,0
10834,7794,6011,24639,2011-07-18,NA,0,0,0
9406,6577,5948,21931,2011-07-19,NA,0,0,0
9930,6950,5607,22487,2011-07-20,NA,0,0,0
10209,6885,5684,22778,2011-07-21,NA,0,0,0
11621,7789,6946,26356,2011-07-22,NA,0,0,0
13827,9133,7324,30284,2011-07-23,NA,0,0,0
13467,9310,6022,28799,2011-07-24,NA,0,0,0
10083,7536,5276,22895,2011-07-25,NA,0,0,0
9377,6582,5236,21195,2011-07-26,NA,0,0,0
9379,6447,4678,20504,2011-07-27,NA,0,0,0
9548,6597,5098,21243,2011-07-28,NA,0,0,0
11085,7294,6163,24542,2011-07-29,NA,0,0,0
12797,8868,7288,28953,2011-07-30,NA,0,0,0
12841,9379,6457,28677,2011-07-31,NA,0,0,0
11381,9139,6087,26607,2011-08-01,"Religious",1,1,0
11236,7367,6872,25475,2011-08-02,NA,1,0,1
11280,8535,7422,27237,2011-08-03,NA,1,1,1
10499,7618,5596,23713,2011-08-04,NA,1,0,0
11494,8380,6720,26594,2011-08-05,NA,1,1,1
13371,10505,8083,31959,2011-08-06,NA,1,1,1
14111,11146,6749,32006,2011-08-07,NA,1,1,0
11813,8302,6239,26354,2011-08-08,NA,1,0,1
11441,8178,6594,26213,2011-08-09,NA,1,1,1
11556,7266,5756,24578,2011-08-10,NA,1,0,0
10370,7950,6388,24708,2011-08-11,NA,0,1,1
11918,9338,7288,28544,2011-08-12,NA,0,1,1
14227,11454,7322,33003,2011-08-13,NA,0,1,0
15256,11302,7351,33909,2011-08-14,NA,0,0,1
11723,9825,6963,28511,2011-08-15,NA,0,1,1
11037,8152,6077,25266,2011-08-16,NA,0,0,0
10163,7827,5691,23681,2011-08-17,NA,0,0,0
10282,7770,5324,23376,2011-08-18,NA,0,0,0
11451,8829,6724,27004,2011-08-19,NA,0,0,0
14025,11170,7063,32258,2011-08-20,NA,0,0,0
15415,12340,6218,33973,2011-08-21,NA,0,0,0
11166,8584,5574,25324,2011-08-22,NA,0,0,0
10026,7483,5108,22617,2011-08-23,NA,0,0,0
9921,6530,5484,21935,2011-08-24,NA,0,0,0
9527,6464,5423,21414,2011-08-25,NA,0,0,0
10979,7184,6105,24268,2011-08-26,NA,0,0,0
13649,9774,6960,30383,2011-08-27,NA,0,0,0
14060,10547,6019,30626,2011-08-28,NA,0,0,0
9890,7054,5141,22085,2011-08-29,NA,0,0,0
8931,6258,5161,20350,2011-08-30,NA,0,0,0
9238,6378,6107,21723,2011-08-31,"Religious",0,0,0
10865,8827,6607,26299,2011-09-01,NA,1,1,0
12472,8211,8525,29208,2011-09-02,NA,1,0,1
14568,10987,8477,34032,2011-09-03,NA,1,1,1
13019,7538,6368,26925,2011-09-04,NA,1,0,0
13807,9371,6980,30158,2011-09-05,"National",1,1,1
12063,7545,6526,26134,2011-09-06,NA,1,1,1
10804,8306,5335,24445,2011-09-07,NA,1,1,0
10879,6992,6177,24048,2011-09-08,NA,1,0,1
12294,8722,7230,28246,2011-09-09,NA,1,1,1
14664,10427,7939,33030,2011-09-10,NA,1,0,0
15086,11559,7987,34632,2011-09-11,NA,0,1,1
10704,8492,6942,26138,2011-09-12,NA,0,1,1
10089,8996,5560,24645,2011-09-13,NA,0,1,0
9776,7365,6364,23505,2011-09-14,NA,0,0,1
10061,8914,7368,26343,2011-09-15,NA,0,1,1
11169,8672,7092,26933,2011-09-16,NA,0,0,0
13587,10510,8098,32195,2011-09-17,NA,0,0,0
14843,10658,6533,32034,2011-09-18,NA,0,0,0
11168,8065,5134,24367,2011-09-19,NA,0,0,0
10500,7056,5119,22675,2011-09-20,NA,0,0,0
10185,6403,5208,21796,2011-09-21,NA,0,0,0
9984,6554,5321,21859,2011-09-22,NA,0,0,0
12504,7942,6260,26706,2011-09-23,NA,0,0,0
14876,10062,7528,32466,2011-09-24,NA,0,0,0
15644,10890,6694,33228,2011-09-25,NA,0,0,0
11231,7635,5224,24090,2011-09-26,NA,0,0,0
10813,6924,5051,22788,2011-09-27,NA,0,0,0
10479,6453,5261,22193,2011-09-28,NA,0,0,0
10203,6762,5418,22383,2011-09-29,NA,0,0,0
12957,9333,7892,30182,2011-09-30,NA,0,0,0
18020,12475,8817,39312,2011-10-01,NA,1,1,0
17094,11153,8967,37214,2011-10-02,NA,1,0,1
13097,9428,7930,30455,2011-10-03,NA,1,1,1
12525,7671,5918,26114,2011-10-04,NA,1,0,0
11262,8050,6601,25913,2011-10-05,NA,1,1,1
11009,8057,7000,26066,2011-10-06,NA,1,1,1
13365,9630,6990,29985,2011-10-07,NA,1,1,0
16599,9984,9347,35930,2011-10-08,NA,1,0,1
16507,10106,9327,35940,2011-10-09,NA,1,1,1
13561,9623,6217,29401,2011-10-10,"National",1,0,0
12035,8545,6847,27427,2011-10-11,NA,0,1,1
11066,9193,7155,27414,2011-10-12,NA,0,1,1
11244,8632,6240,26116,2011-10-13,NA,0,1,0
13338,8488,8059,29885,2011-10-14,NA,0,0,1
16285,11799,10342,38426,2011-10-15,NA,0,1,1
16289,11864,7974,36127,2011-10-16,NA,0,0,0
12373,8841,6378,27592,2011-10-17,NA,0,0,0
10748,7826,5628,24202,2011-10-18,NA,0,0,0
10247,7082,5112,22441,2011-10-19,NA,0,0,0
10350,6850,5202,22402,2011-10-20,NA,0,0,0
12600,7942,6588,27130,2011-10-21,NA,0,0,0
15555,9982,7614,33151,2011-10-22,NA,0,0,0
15709,10427,6740,32876,2011-10-23,NA,0,0,0
11321,7832,5363,24516,2011-10-24,NA,0,0,0
10278,6919,5240,22437,2011-10-25,NA,0,0,0
9747,7055,5340,22142,2011-10-26,NA,0,0,0
10419,6825,5738,22982,2011-10-27,NA,0,0,0
11718,7734,7428,26880,2011-10-28,NA,0,0,0
15724,9473,8022,33219,2011-10-29,NA,0,0,0
16057,9647,6149,31853,2011-10-30,NA,0,0,0
10191,7218,5286,22695,2011-10-31,"Cultural",0,0,0
11094,8384,6561,26039,2011-11-01,NA,1,1,0
11227,7191,6390,24808,2011-11-02,NA,1,0,1
11972,8193,7737,27902,2011-11-03,NA,1,1,1
13252,7868,7476,28596,2011-11-04,NA,1,0,0
16293,10807,9787,36887,2011-11-05,NA,1,1,1
17402,11608,8877,37887,2011-11-06,NA,1,1,1
12654,8943,5681,27278,2011-11-07,"Religious",1,1,0
11987,6793,6408,25188,2011-11-08,NA,1,0,1
11442,8143,6507,26092,2011-11-09,NA,1,1,1
12375,7213,6559,26147,2011-11-10,NA,1,0,0
13522,8425,7808,29755,2011-11-11,"National",0,1,1
15332,10782,9808,35922,2011-11-12,NA,0,1,1
15584,11654,8110,35348,2011-11-13,NA,0,1,0
11665,8462,6646,26773,2011-11-14,NA,0,0,1
10860,8414,7427,26701,2011-11-15,NA,0,1,1
10281,7426,6221,23928,2011-11-16,NA,0,0,0
10244,7206,5664,23114,2011-11-17,NA,0,0,0
12106,7601,6800,26507,2011-11-18,NA,0,0,0
16144,9488,7913,33545,2011-11-19,NA,0,0,0
15546,10141,7066,32753,2011-11-20,NA,0,0,0
12213,7925,5436,25574,2011-11-21,NA,0,0,0
12047,7813,5794,25654,2011-11-22,NA,0,0,0
13587,10465,6735,30787,2011-11-23,NA,0,0,0
7356,7361,3710,18427,2011-11-24,"National",0,0,0
10726,6790,6482,23998,2011-11-25,NA,0,0,0
11762,6923,6607,25292,2011-11-26,NA,0,0,0
12714,8050,6370,27134,2011-11-27,NA,0,0,0
10501,6342,5535,22378,2011-11-28,NA,0,0,0
9993,6305,5286,21584,2011-11-29,NA,0,0,0
9455,6314,5320,21089,2011-11-30,NA,0,0,0
11572,8053,6643,26268,2011-12-01,NA,1,1,0
13326,7741,8660,29727,2011-12-02,NA,1,0,1
17353,10618,10158,38129,2011-12-03,NA,1,1,1
16724,10136,8218,35078,2011-12-04,NA,1,0,0
13173,8415,7632,29220,2011-12-05,NA,1,1,1
11773,8357,7137,27267,2011-12-06,NA,1,1,1
11594,7850,6009,25453,2011-12-07,NA,1,1,0
12133,6701,7513,26347,2011-12-08,NA,1,0,1
12985,8401,8052,29438,2011-12-09,NA,1,1,1
16330,9205,9251,34786,2011-12-10,NA,1,0,0
15956,11283,8504,35743,2011-12-11,NA,0,1,1
12691,9194,7266,29151,2011-12-12,NA,0,1,1
11733,8881,6299,26913,2011-12-13,NA,0,1,0
10962,8557,7275,26794,2011-12-14,NA,0,0,1
12215,9558,7871,29644,2011-12-15,NA,0,1,1
12697,8521,7667,28885,2011-12-16,NA,0,0,0
15522,9998,8639,34159,2011-12-17,NA,0,0,0
15434,9351,7302,32087,2011-12-18,NA,0,0,0
12610,8011,6447,27068,2011-12-19,NA,0,0,0
12023,7657,6582,26262,2011-12-20,NA,0,0,0
12182,8174,6306,26662,2011-12-21,NA,0,0,0
12706,8596,6880,28182,2011-12-22,NA,0,0,0
15765,10177,8704,34646,2011-12-23,NA,0,0,0
12557,9803,7598,29958,2011-12-24,NA,0,0,0
8,2,3,13,2011-12-25,"National",0,0,0
12390,9044,6598,28032,2011-12-26,NA,0,0,0
11775,7274,5602,24651,2011-12-27,NA,0,0,0
11737,7294,5760,24791,2011-12-28,"Religious",0,0,0
11761,7139,5641,24541,2011-12-29,NA,0,0,0
15763,9371,8518,33652,2011-12-30,NA,0,0,0
14365,10491,8895,33751,2011-12-31,NA,0,0,0
10218,7224,4365,21807,2012-01-01,"National",1,1,0
15152,9307,8594,33053,2012-01-02,NA,1,0,1
12740,8345,7666,28751,2012-01-03,NA,1,1,1
11512,7530,6779,25821,2012-01-04,NA,1,0,0
12283,8558,7658,28499,2012-01-05,NA,1,1,1
12809,9197,8399,30405,2012-01-06,NA,1,1,1
16634,11191,9318,37143,2012-01-07,"Religious",1,1,0
17261,10981,8480,36722,2012-01-08,NA,1,0,1
13418,7173,7615,28206,2012-01-09,NA,1,1,1
12192,7940,6508,26640,2012-01-10,NA,1,0,0
11470,8551,9023,29044,2012-01-11,NA,0,1,1
10549,7901,6265,24715,2012-01-12,NA,0,1,1
13098,9508,6857,29463,2012-01-13,NA,0,1,0
15748,10482,10585,36815,2012-01-14,NA,0,0,1
15729,11336,9394,36459,2012-01-15,NA,0,1,1
14013,9018,7517,30548,2012-01-16,"National",0,0,0
10525,6925,4737,22187,2012-01-17,NA,0,0,0
11172,7249,6927,25348,2012-01-18,NA,0,0,0
10689,7069,6276,24034,2012-01-19,NA,0,0,0
12202,8441,6561,27204,2012-01-20,NA,0,0,0
18418,10606,9554,38578,2012-01-21,NA,0,0,0
14539,10434,7614,32587,2012-01-22,NA,0,0,0
11365,7619,5718,24702,2012-01-23,NA,0,0,0
11109,6593,5847,23549,2012-01-24,NA,0,0,0
10622,6163,5623,22408,2012-01-25,NA,0,0,0
10471,6757,6009,23237,2012-01-26,NA,0,0,0
12353,7920,6926,27199,2012-01-27,NA,0,0,0
15406,10189,8767,34362,2012-01-28,NA,0,0,0
16101,10428,7048,33577,2012-01-29,NA,0,0,0
11745,7645,5798,25188,2012-01-30,NA,0,0,0
11836,7136,6152,25124,2012-01-31,NA,0,0,0
12931,9481,7439,29851,2012-02-01,NA,1,1,0
12804,7708,8103,28615,2012-02-02,NA,1,0,1
15263,9950,9891,35104,2012-02-03,NA,1,1,1
20129,12224,10676,43029,2012-02-04,NA,1,0,0
17149,13255,9671,40075,2012-02-05,"Sporting",1,1,1
13798,9108,7775,30681,2012-02-06,NA,1,1,1
12785,8889,6434,28108,2012-02-07,NA,1,1,0
12568,8174,7837,28579,2012-02-08,NA,1,0,1
12783,8329,8815,29927,2012-02-09,NA,1,1,1
14425,8128,7310,29863,2012-02-10,NA,1,0,0
19661,11675,10421,41757,2012-02-11,NA,0,1,1
18559,12585,10760,41904,2012-02-12,NA,0,1,1
13954,10394,7327,31675,2012-02-13,NA,0,1,0
10417,8084,6599,25100,2012-02-14,"Cultural",0,0,1
10994,8240,7644,26878,2012-02-15,NA,0,1,1
10984,7754,6457,25195,2012-02-16,NA,0,0,0
12922,7653,7029,27604,2012-02-17,NA,0,0,0
16872,10383,9367,36622,2012-02-18,NA,0,0,0
16159,11747,8432,36338,2012-02-19,NA,0,0,0
15012,8907,6299,30218,2012-02-20,"National",0,0,0
11695,7529,5966,25190,2012-02-21,NA,0,0,0
10847,7091,6177,24115,2012-02-22,"Religious",0,0,0
11506,7423,6282,25211,2012-02-23,NA,0,0,0
13707,7914,6249,27870,2012-02-24,NA,0,0,0
16555,9801,9413,35769,2012-02-25,NA,0,0,0
16642,11486,8153,36281,2012-02-26,NA,0,0,0
12306,8578,6386,27270,2012-02-27,NA,0,0,0
10826,7474,6059,24359,2012-02-28,NA,0,0,0
11237,7570,5995,24802,2012-02-29,"Religious",0,0,0
13345,9398,7489,30232,2012-03-01,NA,1,1,0
15070,9186,8287,32543,2012-03-02,NA,1,0,1
18599,11479,11241,41319,2012-03-03,NA,1,1,1
19659,11556,9110,40325,2012-03-04,NA,1,0,0
14495,10091,8117,32703,2012-03-05,NA,1,1,1
13714,9198,8620,31532,2012-03-06,NA,1,1,1
13444,8623,6541,28608,2012-03-07,NA,1,1,0
13510,8320,7929,29759,2012-03-08,"Religious",1,0,1
14999,8464,8859,32322,2012-03-09,NA,1,1,1
18693,11508,9358,39559,2012-03-10,NA,1,0,0
19895,11973,8744,40612,2012-03-11,NA,0,1,1
14208,10659,7634,32501,2012-03-12,NA,0,1,1
12027,10424,6649,29100,2012-03-13,NA,0,1,0
11442,9328,7071,27841,2012-03-14,NA,0,0,1
12217,10192,8343,30752,2012-03-15,NA,0,1,1
13203,9867,7881,30951,2012-03-16,NA,0,0,0
18035,10571,9298,37904,2012-03-17,"Cultural",0,0,0
17657,11908,8129,37694,2012-03-18,NA,0,0,0
13338,9190,6659,29187,2012-03-19,NA,0,0,0
11847,7490,6196,25533,2012-03-20,NA,0,0,0
11486,8107,6634,26227,2012-03-21,NA,0,0,0
11851,8128,6036,26015,2012-03-22,NA,0,0,0
13339,8995,6721,29055,2012-03-23,NA,0,0,0
16871,11133,9085,37089,2012-03-24,NA,0,0,0
18402,11664,7777,37843,2012-03-25,NA,0,0,0
12909,8595,5678,27182,2012-03-26,NA,0,0,0
10868,7899,5882,24649,2012-03-27,NA,0,0,0
11820,7311,5652,24783,2012-03-28,NA,0,0,0
10902,7304,5673,23879,2012-03-29,NA,0,0,0
14468,9012,7252,30732,2012-03-30,NA,0,0,0
17706,11017,9740,38463,2012-03-31,NA,0,0,0
18364,13427,7992,39783,2012-04-01,NA,1,1,0
14409,8717,8233,31359,2012-04-02,NA,1,0,1
14685,10213,8135,33033,2012-04-03,NA,1,1,1
13210,8372,6736,28318,2012-04-04,NA,1,0,0
14080,9582,7706,31368,2012-04-05,NA,1,1,1
16567,11741,9237,37545,2012-04-06,NA,1,1,1
21332,14331,9975,45638,2012-04-07,NA,1,1,0
16717,12377,7116,36210,2012-04-08,"Cultural",1,0,1
14798,9553,7642,31993,2012-04-09,NA,1,1,1
13265,8757,6778,28800,2012-04-10,NA,1,0,0
12768,9372,7435,29575,2012-04-11,NA,0,1,1
11970,8998,7600,28568,2012-04-12,NA,0,1,1
13809,10255,7874,31938,2012-04-13,NA,0,1,0
17340,11717,9489,38546,2012-04-14,"Religious",0,0,1
16661,13304,8742,38707,2012-04-15,"Religious",0,1,1
12652,8285,6735,27672,2012-04-16,NA,0,0,0
11179,8696,6192,26067,2012-04-17,NA,0,0,0
11358,7849,5492,24699,2012-04-18,NA,0,0,0
11805,8022,4997,24824,2012-04-19,NA,0,0,0
13739,7946,6458,28143,2012-04-20,NA,0,0,0
17336,10893,8479,36708,2012-04-21,NA,0,0,0
17793,11660,7311,36764,2012-04-22,NA,0,0,0
12217,8879,5574,26670,2012-04-23,NA,0,0,0
11545,7727,5576,24848,2012-04-24,NA,0,0,0
11052,7873,5523,24448,2012-04-25,NA,0,0,0
11014,7832,5684,24530,2012-04-26,NA,0,0,0
13571,8572,6834,28977,2012-04-27,NA,0,0,0
16121,10820,8706,35647,2012-04-28,NA,0,0,0
16904,11736,7484,36124,2012-04-29,NA,0,0,0
12736,8617,6003,27356,2012-04-30,NA,0,0,0
13593,9577,7120,30290,2012-05-01,NA,1,1,0
12967,8471,7801,29239,2012-05-02,NA,1,0,1
14081,10032,8846,32959,2012-05-03,NA,1,1,1
14797,9702,8433,32932,2012-05-04,NA,1,0,0
16234,12783,10184,39201,2012-05-05,"Cultural",1,1,1
18559,13623,9347,41529,2012-05-06,NA,1,1,1
15317,11079,7081,33477,2012-05-07,NA,1,1,0
14245,8512,7676,30433,2012-05-08,NA,1,0,1
13234,9165,7805,30204,2012-05-09,NA,1,1,1
13339,8095,6730,28164,2012-05-10,NA,1,0,0
14784,9271,8759,32814,2012-05-11,NA,0,1,1
17860,12271,10741,40872,2012-05-12,NA,0,1,1
14807,11677,7285,33769,2012-05-13,"Cultural",0,1,0
13120,9793,8670,31583,2012-05-14,NA,0,0,1
13144,9832,8782,31758,2012-05-15,NA,0,1,1
12590,8694,7393,28677,2012-05-16,NA,0,0,0
12219,8195,6909,27323,2012-05-17,NA,0,0,0
14797,9440,8074,32311,2012-05-18,NA,0,0,0
17400,11211,9318,37929,2012-05-19,NA,0,0,0
18147,12453,8914,39514,2012-05-20,NA,0,0,0
13282,8744,6779,28805,2012-05-21,NA,0,0,0
11964,8943,6595,27502,2012-05-22,NA,0,0,0
11560,8299,6764,26623,2012-05-23,NA,0,0,0
12118,8841,7004,27963,2012-05-24,NA,0,0,0
14411,9786,8600,32797,2012-05-25,NA,0,0,0
15753,11905,9581,37239,2012-05-26,NA,0,0,0
14766,11382,7705,33853,2012-05-27,NA,0,0,0
14997,11254,7156,33407,2012-05-28,"National",0,0,0
12934,9172,6514,28620,2012-05-29,NA,0,0,0
12078,8441,6631,27150,2012-05-30,NA,0,0,0
13501,8090,7218,28809,2012-05-31,NA,0,0,0
16806,12246,10477,39529,2012-06-01,NA,1,1,0
19460,12716,12767,44943,2012-06-02,NA,1,0,1
19136,13271,11503,43910,2012-06-03,NA,1,1,1
14681,10216,8397,33294,2012-06-04,NA,1,0,0
14299,10210,9497,34006,2012-06-05,NA,1,1,1
13663,10184,9740,33587,2012-06-06,NA,1,1,1
14102,10584,7849,32535,2012-06-07,NA,1,1,0
15783,10007,11111,36901,2012-06-08,NA,1,0,1
17841,12964,12504,43309,2012-06-09,NA,1,1,1
20274,13861,10809,44944,2012-06-10,NA,1,0,0
16775,12000,10861,39636,2012-06-11,NA,0,1,1
14676,10051,10347,35074,2012-06-12,"Sporting",0,1,1
13940,10428,8562,32930,2012-06-13,NA,0,1,0
14393,9470,9919,33782,2012-06-14,NA,0,0,1
17087,12276,12435,41798,2012-06-15,NA,0,1,1
19531,13073,11834,44438,2012-06-16,NA,0,0,0
17345,12530,9164,39039,2012-06-17,"Cultural",0,0,0
15141,10337,8622,34100,2012-06-18,NA,0,0,0
14078,8837,9052,31967,2012-06-19,NA,0,0,0
13617,9277,8574,31468,2012-06-20,NA,0,0,0
13504,8936,8324,30764,2012-06-21,"Sporting",0,0,0
16055,10678,9744,36477,2012-06-22,NA,0,0,0
17793,12009,10208,40010,2012-06-23,NA,0,0,0
18336,12518,9655,40509,2012-06-24,NA,0,0,0
13793,10251,7803,31847,2012-06-25,NA,0,0,0
12368,9153,7850,29371,2012-06-26,NA,0,0,0
12521,8784,7580,28885,2012-06-27,NA,0,0,0
13366,8339,7880,29585,2012-06-28,NA,0,0,0
15521,10385,10471,36377,2012-06-29,NA,0,0,0
17961,11189,11444,40594,2012-06-30,NA,0,0,0
18577,12257,9865,40699,2012-07-01,NA,1,1,0
15238,9544,11081,35863,2012-07-02,NA,1,0,1
16147,10825,12570,39542,2012-07-03,NA,1,1,1
13944,9860,8852,32656,2012-07-04,"National",1,0,0
13675,9626,11107,34408,2012-07-05,NA,1,1,1
16184,11319,12488,39991,2012-07-06,NA,1,1,1
17614,12879,10938,41431,2012-07-07,NA,1,1,0
19172,11795,11705,42672,2012-07-08,NA,1,0,1
15720,9576,10474,35770,2012-07-09,NA,1,1,1
15098,8763,8726,32587,2012-07-10,NA,1,0,0
13924,9426,9722,33072,2012-07-11,NA,0,1,1
13841,9163,10073,33077,2012-07-12,NA,0,1,1
15643,10867,10072,36582,2012-07-13,NA,0,1,0
17819,12206,12323,42348,2012-07-14,NA,0,0,1
18103,13205,12381,43689,2012-07-15,NA,0,1,1
14147,9364,9509,33020,2012-07-16,NA,0,0,0
13532,8462,8424,30418,2012-07-17,NA,0,0,0
12834,8374,7708,28916,2012-07-18,NA,0,0,0
14045,9051,7768,30864,2012-07-19,NA,0,0,0
15803,10581,9018,35402,2012-07-20,"Religious",0,0,0
17811,11633,10100,39544,2012-07-21,NA,0,0,0
18734,12342,8876,39952,2012-07-22,NA,0,0,0
14194,8742,7928,30864,2012-07-23,NA,0,0,0
13219,8656,7604,29479,2012-07-24,NA,0,0,0
12805,8142,7407,28354,2012-07-25,NA,0,0,0
13096,8255,7187,28538,2012-07-26,NA,0,0,0
14101,9333,8406,31840,2012-07-27,NA,0,0,0
15373,10809,8406,34588,2012-07-28,NA,0,0,0
16011,11602,8534,36147,2012-07-29,NA,0,0,0
12750,8683,7500,28933,2012-07-30,NA,0,0,0
13568,8606,7357,29531,2012-07-31,NA,0,0,0
14121,10608,9241,33970,2012-08-01,NA,1,1,0
15275,9864,10121,35260,2012-08-02,NA,1,0,1
16593,11185,11733,39511,2012-08-03,NA,1,1,1
18433,12626,10217,41276,2012-08-04,NA,1,0,0
19272,12506,11231,43009,2012-08-05,NA,1,1,1
16003,11093,9928,37024,2012-08-06,NA,1,1,1
14359,10129,7906,32394,2012-08-07,NA,1,1,0
14237,8853,9211,32301,2012-08-08,NA,1,0,1
14908,10141,9959,35008,2012-08-09,NA,1,1,1
16846,9842,9777,36465,2012-08-10,NA,1,0,0
19618,13363,11100,44081,2012-08-11,NA,0,1,1
19675,14274,11849,45798,2012-08-12,NA,0,1,1
15647,11784,8599,36030,2012-08-13,NA,0,1,0
15103,9529,9680,34312,2012-08-14,NA,0,0,1
14431,10688,10378,35497,2012-08-15,NA,0,1,1
14885,10244,9276,34405,2012-08-16,NA,0,0,0
15667,10706,9084,35457,2012-08-17,NA,0,0,0
19446,11742,10333,41521,2012-08-18,NA,0,0,0
20637,13269,9458,43364,2012-08-19,"Religious",0,0,0
14856,9809,7745,32410,2012-08-20,NA,0,0,0
13795,8754,7657,30206,2012-08-21,NA,0,0,0
13279,8666,6977,28922,2012-08-22,NA,0,0,0
12454,8916,7182,28552,2012-08-23,NA,0,0,0
14717,9910,8417,33044,2012-08-24,NA,0,0,0
17991,12399,9574,39964,2012-08-25,NA,0,0,0
18447,13402,9172,41021,2012-08-26,NA,0,0,0
13487,9860,7663,31010,2012-08-27,NA,0,0,0
12446,8626,7400,28472,2012-08-28,NA,0,0,0
12216,7822,7063,27101,2012-08-29,NA,0,0,0
12468,8389,7446,28303,2012-08-30,NA,0,0,0
15594,10350,11148,37092,2012-08-31,NA,0,0,0
19396,13998,11236,44630,2012-09-01,NA,1,1,0
18287,12397,12135,42819,2012-09-02,NA,1,0,1
19074,13484,11967,44525,2012-09-03,"National",1,1,1
14368,9054,8457,31879,2012-09-04,NA,1,0,0
13105,9408,9341,31854,2012-09-05,NA,1,1,1
13466,9868,9241,32575,2012-09-06,NA,1,1,1
15010,11088,8677,34775,2012-09-07,NA,1,1,0
18574,12389,12255,43218,2012-09-08,NA,1,0,1
20447,13874,12328,46649,2012-09-09,NA,1,1,1
15467,9698,7807,32972,2012-09-10,NA,1,0,0
13975,9248,9147,32370,2012-09-11,NA,0,1,1
12376,9088,9554,31018,2012-09-12,NA,0,1,1
13077,9025,8040,30142,2012-09-13,NA,0,1,0
14995,10174,11190,36359,2012-09-14,NA,0,0,1
18557,13821,13581,45959,2012-09-15,NA,0,1,1
19480,13502,11304,44286,2012-09-16,NA,0,0,0
13539,10041,8280,31860,2012-09-17,NA,0,0,0
12917,8364,7995,29276,2012-09-18,NA,0,0,0
11513,8221,7331,27065,2012-09-19,NA,0,0,0
12446,8486,7625,28557,2012-09-20,NA,0,0,0
14819,9852,8963,33634,2012-09-21,NA,0,0,0
18583,12772,10534,41889,2012-09-22,NA,0,0,0
18358,13063,9941,41362,2012-09-23,NA,0,0,0
13141,9124,6911,29176,2012-09-24,NA,0,0,0
12357,8552,7070,27979,2012-09-25,NA,0,0,0
11735,8337,6860,26932,2012-09-26,NA,0,0,0
12002,8238,6991,27231,2012-09-27,NA,0,0,0
14550,9331,8775,32656,2012-09-28,NA,0,0,0
18164,11862,10955,40981,2012-09-29,NA,0,0,0
18310,12086,9340,39736,2012-09-30,NA,0,0,0
15728,11017,8096,34841,2012-10-01,NA,1,1,0
15113,9059,9658,33830,2012-10-02,NA,1,0,1
14297,9821,10102,34220,2012-10-03,NA,1,1,1
13337,8576,8162,30075,2012-10-04,NA,1,0,0
14559,10156,9873,34588,2012-10-05,NA,1,1,1
18576,12825,12639,44040,2012-10-06,NA,1,1,1
18997,13041,9834,41872,2012-10-07,NA,1,1,0
15393,9386,9011,33790,2012-10-08,"National",1,0,1
13502,9538,9255,32295,2012-10-09,NA,1,1,1
12974,8919,8076,29969,2012-10-10,NA,1,0,0
11826,9360,8812,29998,2012-10-11,NA,0,1,1
14209,10577,10266,35052,2012-10-12,NA,0,1,1
17236,13634,11356,42226,2012-10-13,NA,0,1,0
17899,13183,11155,42237,2012-10-14,NA,0,0,1
12972,11156,9556,33684,2012-10-15,NA,0,1,1
11722,8284,7863,27869,2012-10-16,NA,0,0,0
11706,8733,6664,27103,2012-10-17,NA,0,0,0
11551,8418,6200,26169,2012-10-18,NA,0,0,0
12990,9109,7612,29711,2012-10-19,NA,0,0,0
16664,11439,8586,36689,2012-10-20,NA,0,0,0
17360,12209,7418,36987,2012-10-21,NA,0,0,0
12433,8776,5503,26712,2012-10-22,NA,0,0,0
11249,8167,6003,25419,2012-10-23,NA,0,0,0
10546,8201,5643,24390,2012-10-24,NA,0,0,0
10821,7807,5684,24312,2012-10-25,NA,0,0,0
12461,8721,10681,31863,2012-10-26,"Religious",0,0,0
15999,10430,12118,38547,2012-10-27,NA,0,0,0
16457,10910,9817,37184,2012-10-28,NA,0,0,0
12014,8160,7407,27581,2012-10-29,NA,0,0,0
12499,8066,7515,28080,2012-10-30,NA,0,0,0
9984,7704,7287,24975,2012-10-31,"Cultural",0,0,0
12550,9145,9356,31051,2012-11-01,NA,1,1,0
14256,9280,11978,35514,2012-11-02,NA,1,0,1
18203,11805,15071,45079,2012-11-03,NA,1,1,1
18597,12091,11857,42545,2012-11-04,NA,1,0,0
13423,9469,10165,33057,2012-11-05,NA,1,1,1
12078,8653,9783,30514,2012-11-06,NA,1,1,1
12254,9080,8349,29683,2012-11-07,NA,1,1,0
12254,8354,10149,30757,2012-11-08,NA,1,0,1
14020,10011,11691,35722,2012-11-09,NA,1,1,1
18128,11467,13289,42884,2012-11-10,NA,1,0,0
17170,12743,13604,43517,2012-11-11,"National",0,1,1
13310,9435,10468,33213,2012-11-12,NA,0,1,1
11167,8507,8634,28308,2012-11-13,NA,0,1,0
10396,7757,9682,27835,2012-11-14,NA,0,0,1
10950,8808,9955,29713,2012-11-15,NA,0,1,1
12996,8681,9939,31616,2012-11-16,NA,0,0,0
16701,11297,12443,40441,2012-11-17,NA,0,0,0
16316,10920,10340,37576,2012-11-18,NA,0,0,0
12791,8803,7736,29330,2012-11-19,NA,0,0,0
12980,9077,8217,30274,2012-11-20,NA,0,0,0
13964,11863,9381,35208,2012-11-21,NA,0,0,0
8002,8259,5648,21909,2012-11-22,"National",0,0,0
9717,7014,6692,23423,2012-11-23,NA,0,0,0
12264,8855,8897,30016,2012-11-24,NA,0,0,0
13768,9632,9332,32732,2012-11-25,NA,0,0,0
11563,7772,7141,26476,2012-11-26,NA,0,0,0
10421,6837,7231,24489,2012-11-27,NA,0,0,0
9809,6743,6993,23545,2012-11-28,NA,0,0,0
9939,6753,7176,23868,2012-11-29,NA,0,0,0
11540,8821,10028,30389,2012-11-30,NA,0,0,0
18180,12408,11908,42496,2012-12-01,NA,1,1,0
15828,12044,13068,40940,2012-12-02,NA,1,0,1
14358,10063,10916,35337,2012-12-03,NA,1,1,1
12172,7581,9066,28819,2012-12-04,NA,1,0,0
11539,9079,10566,31184,2012-12-05,NA,1,1,1
12123,8908,10093,31124,2012-12-06,NA,1,1,1
13740,9950,9904,33594,2012-12-07,NA,1,1,0
16734,11639,13200,41573,2012-12-08,NA,1,0,1
17164,12532,12830,42526,2012-12-09,NA,1,1,1
14030,8088,8971,31089,2012-12-10,NA,1,0,0
12154,8368,9776,30298,2012-12-11,NA,0,1,1
11147,8821,10048,30016,2012-12-12,NA,0,1,1
11481,8892,8298,28671,2012-12-13,NA,0,1,0
12586,9219,11097,32902,2012-12-14,NA,0,0,1
16288,12347,13755,42390,2012-12-15,NA,0,1,1
16738,11821,11494,40053,2012-12-16,"Religious",0,0,0
12454,9757,8814,31025,2012-12-17,NA,0,0,0
12715,9215,8324,30254,2012-12-18,NA,0,0,0
11471,9340,10971,31782,2012-12-19,NA,0,0,0
12640,9571,8661,30872,2012-12-20,NA,0,0,0
13684,9543,9621,32848,2012-12-21,NA,0,0,0
16669,11111,12235,40015,2012-12-22,NA,0,0,0
15476,11884,11627,38987,2012-12-23,NA,0,0,0
13360,10404,8859,32623,2012-12-24,NA,0,0,0
6,2,3,11,2012-12-25,"National",0,0,0
12072,10020,7609,29701,2012-12-26,NA,0,0,0
12289,8507,8290,29086,2012-12-27,NA,0,0,0
12801,9991,9555,32347,2012-12-28,NA,0,0,0
15204,10819,11131,37154,2012-12-29,NA,0,0,0
15023,10801,9875,35699,2012-12-30,NA,0,0,0
13715,10576,10745,35036,2012-12-31,NA,0,0,0
9640,8334,6113,24087,2013-01-01,"National",1,1,0
13252,8387,10545,32184,2013-01-02,NA,1,0,1
14202,10069,11970,36241,2013-01-03,NA,1,1,1
14526,8861,10355,33742,2013-01-04,NA,1,0,0
17101,11310,14876,43287,2013-01-05,NA,1,1,1
17773,12705,13516,43994,2013-01-06,NA,1,1,1
13805,10644,9068,33517,2013-01-07,"Religious",1,1,0
13098,8035,10087,31220,2013-01-08,NA,1,0,1
11387,7519,10626,29532,2013-01-09,NA,1,1,1
12615,8402,8776,29793,2013-01-10,NA,1,0,0
13487,9521,11468,34476,2013-01-11,NA,0,1,1
17781,12952,15145,45878,2013-01-12,NA,0,1,1
17260,12369,10578,40207,2013-01-13,NA,0,1,0
12151,8407,10056,30614,2013-01-14,NA,0,0,1
11634,8313,10954,30901,2013-01-15,NA,0,1,1
11598,8192,9012,28802,2013-01-16,NA,0,0,0
11854,7923,8593,28370,2013-01-17,NA,0,0,0
13495,9210,10107,32812,2013-01-18,NA,0,0,0
17671,11441,13155,42267,2013-01-19,NA,0,0,0
15199,11493,10349,37041,2013-01-20,NA,0,0,0
13849,9222,7816,30887,2013-01-21,"National",0,0,0
11368,7516,6672,25556,2013-01-22,NA,0,0,0
10669,7396,7529,25594,2013-01-23,NA,0,0,0
10077,7494,7396,24967,2013-01-24,NA,0,0,0
13134,8224,8494,29852,2013-01-25,NA,0,0,0
17658,10988,12047,40693,2013-01-26,NA,0,0,0
17206,11222,9999,38427,2013-01-27,NA,0,0,0
11924,8348,7524,27796,2013-01-28,NA,0,0,0
11258,7204,7087,25549,2013-01-29,NA,0,0,0
10263,7071,6189,23523,2013-01-30,NA,0,0,0
11785,7477,7489,26751,2013-01-31,NA,0,0,0
15823,11282,11971,39076,2013-02-01,NA,1,1,0
21731,13342,15959,51032,2013-02-02,NA,1,0,1
15365,12674,13519,41558,2013-02-03,"Sporting",1,1,1
12548,8661,7783,28992,2013-02-04,NA,1,0,0
11910,9433,10290,31633,2013-02-05,NA,1,1,1
11924,8777,11236,31937,2013-02-06,NA,1,1,1
12428,9930,7341,29699,2013-02-07,NA,1,1,0
13986,10281,11279,35546,2013-02-08,NA,1,0,1
17488,13094,15270,45852,2013-02-09,NA,1,1,1
17372,13720,12818,43910,2013-02-10,NA,1,0,0
14864,10046,11707,36617,2013-02-11,NA,0,1,1
13291,10406,12444,36141,2013-02-12,NA,0,1,1
14147,12009,12395,38551,2013-02-13,"Religious",0,1,0
11196,8580,10433,30209,2013-02-14,"Cultural",0,0,1
14178,10631,13451,38260,2013-02-15,NA,0,1,1
17563,12785,14809,45157,2013-02-16,NA,0,0,0
17250,14094,13309,44653,2013-02-17,NA,0,0,0
15076,10486,9076,34638,2013-02-18,"National",0,0,0
11609,9169,7470,28248,2013-02-19,NA,0,0,0
12233,8850,9118,30201,2013-02-20,"Religious",0,0,0
12258,9297,9853,31408,2013-02-21,NA,0,0,0
14171,9665,8727,32563,2013-02-22,NA,0,0,0
18348,12066,12617,43031,2013-02-23,NA,0,0,0
18358,13694,12090,44142,2013-02-24,"Religious",0,0,0
13713,9352,8955,32020,2013-02-25,NA,0,0,0
11596,8567,7165,27328,2013-02-26,NA,0,0,0
11844,8503,7537,27884,2013-02-27,NA,0,0,0
12625,8430,9319,30374,2013-02-28,NA,0,0,0
16092,11283,12076,39451,2013-03-01,NA,1,1,0
20494,13200,16078,49772,2013-03-02,NA,1,0,1
19787,13493,14967,48247,2013-03-03,NA,1,1,1
14410,10021,11386,35817,2013-03-04,NA,1,0,0
13081,9651,8504,31236,2013-03-05,NA,1,1,1
12395,9324,10309,32028,2013-03-06,NA,1,1,1
11588,9355,8827,29770,2013-03-07,NA,1,1,0
14704,8642,10946,34292,2013-03-08,NA,1,0,1
18334,12272,14283,44889,2013-03-09,NA,1,1,1
18868,12340,12900,44108,2013-03-10,NA,1,0,0
14548,11331,10559,36438,2013-03-11,NA,0,1,1
12768,10256,10768,33792,2013-03-12,NA,0,1,1
12532,10092,9184,31808,2013-03-13,NA,0,1,0
12904,9410,10853,33167,2013-03-14,NA,0,0,1
14889,10761,11851,37501,2013-03-15,NA,0,1,1
17726,11876,14050,43652,2013-03-16,NA,0,0,0
18239,12361,11970,42570,2013-03-17,"Cultural",0,0,0
13262,9923,8180,31365,2013-03-18,NA,0,0,0
11851,8708,8453,29012,2013-03-19,NA,0,0,0
12716,8318,8422,29456,2013-03-20,NA,0,0,0
12561,8798,8283,29642,2013-03-21,NA,0,0,0
14455,9469,9244,33168,2013-03-22,NA,0,0,0
17535,11267,11818,40620,2013-03-23,NA,0,0,0
17216,12057,11360,40633,2013-03-24,NA,0,0,0
13051,8735,7881,29667,2013-03-25,NA,0,0,0
12098,8465,8069,28632,2013-03-26,NA,0,0,0
12240,8188,7830,28258,2013-03-27,NA,0,0,0
13025,8223,8406,29654,2013-03-28,NA,0,0,0
15732,11323,11012,38067,2013-03-29,NA,0,0,0
19945,13001,13464,46410,2013-03-30,NA,0,0,0
13769,11899,8780,34448,2013-03-31,"Cultural",0,0,0
14427,10745,9350,34522,2013-04-01,NA,1,1,0
14391,8958,11293,34642,2013-04-02,"Religious",1,0,1
14759,9062,11773,35594,2013-04-03,NA,1,1,1
14109,8925,9140,32174,2013-04-04,NA,1,0,0
16073,10519,11464,38056,2013-04-05,NA,1,1,1
19195,12876,14750,46821,2013-04-06,NA,1,1,1
20337,13965,12142,46444,2013-04-07,NA,1,1,0
14638,10104,10275,35017,2013-04-08,NA,1,0,1
14564,10052,9134,33750,2013-04-09,NA,1,1,1
14230,8392,8819,31441,2013-04-10,NA,1,0,0
13647,9502,9543,32692,2013-04-11,NA,0,1,1
14782,10013,11287,36082,2013-04-12,NA,0,1,1
18260,12536,12849,43645,2013-04-13,NA,0,1,0
18310,12931,12749,43990,2013-04-14,NA,0,0,1
13807,11045,9250,34102,2013-04-15,NA,0,1,1
13180,8993,8866,31039,2013-04-16,NA,0,0,0
12736,8473,7606,28815,2013-04-17,NA,0,0,0
12629,8158,7687,28474,2013-04-18,NA,0,0,0
14810,9635,8384,32829,2013-04-19,NA,0,0,0
18193,11886,10778,40857,2013-04-20,NA,0,0,0
19123,11536,9272,39931,2013-04-21,NA,0,0,0
14251,8935,6765,29951,2013-04-22,NA,0,0,0
12559,8472,6028,27059,2013-04-23,NA,0,0,0
12542,7996,7069,27607,2013-04-24,NA,0,0,0
12533,7797,7146,27476,2013-04-25,NA,0,0,0
14093,9423,7690,31206,2013-04-26,NA,0,0,0
17185,8624,9520,35329,2013-04-27,NA,0,0,0
18028,12207,8667,38902,2013-04-28,NA,0,0,0
12903,7869,6673,27445,2013-04-29,NA,0,0,0
13258,8124,6762,28144,2013-04-30,NA,0,0,0
14286,9197,7875,31358,2013-05-01,NA,1,1,0
14214,8125,9402,31741,2013-05-02,NA,1,0,1
16459,9650,10841,36950,2013-05-03,NA,1,1,1
18770,10800,11242,40812,2013-05-04,NA,1,0,0
18927,12305,11971,43203,2013-05-05,"Religious",1,1,1
15987,9847,9534,35368,2013-05-06,NA,1,1,1
14308,9495,7870,31673,2013-05-07,NA,1,1,0
13429,9106,8811,31346,2013-05-08,NA,1,0,1
13958,9446,9534,32938,2013-05-09,NA,1,1,1
15462,8519,9516,33497,2013-05-10,NA,1,0,0
20060,12328,12997,45385,2013-05-11,NA,0,1,1
16414,11379,9597,37390,2013-05-12,"Cultural",0,1,1
14890,11084,8635,34609,2013-05-13,NA,0,1,0
14287,9457,9141,32885,2013-05-14,NA,0,0,1
14158,9990,10463,34611,2013-05-15,NA,0,1,1
13562,9500,8875,31937,2013-05-16,NA,0,0,0
14936,10055,9691,34682,2013-05-17,NA,0,0,0
18020,12789,10021,40830,2013-05-18,NA,0,0,0
19633,13340,9700,42673,2013-05-19,NA,0,0,0
15437,10096,8113,33646,2013-05-20,NA,0,0,0
13479,8931,7876,30286,2013-05-21,NA,0,0,0
13096,8912,6927,28935,2013-05-22,NA,0,0,0
14016,8753,8133,30902,2013-05-23,NA,0,0,0
15787,10225,9069,35081,2013-05-24,NA,0,0,0
17170,11816,10157,39143,2013-05-25,NA,0,0,0
16344,11647,8058,36049,2013-05-26,NA,0,0,0
17033,11139,8105,36277,2013-05-27,"National",0,0,0
13924,8608,6766,29298,2013-05-28,NA,0,0,0
12350,7644,6973,26967,2013-05-29,NA,0,0,0
12661,8329,7135,28125,2013-05-30,NA,0,0,0
16213,9646,10227,36086,2013-05-31,NA,0,0,0
19759,13829,11220,44808,2013-06-01,NA,1,1,0
21500,12868,13134,47502,2013-06-02,NA,1,0,1
16824,11180,11241,39245,2013-06-03,NA,1,1,1
15176,9546,9087,33809,2013-06-04,NA,1,0,0
15639,10579,9693,35911,2013-06-05,NA,1,1,1
14096,10520,9550,34166,2013-06-06,"Sporting",1,1,1
17107,11280,9215,37602,2013-06-07,NA,1,1,0
20488,12262,11897,44647,2013-06-08,NA,1,0,1
21873,13317,12974,48164,2013-06-09,NA,1,1,1
17630,10451,8688,36769,2013-06-10,NA,1,0,0
15070,10312,9243,34625,2013-06-11,NA,0,1,1
14339,10052,9551,33942,2013-06-12,NA,0,1,1
14910,10524,8754,34188,2013-06-13,NA,0,1,0
17282,11206,11279,39767,2013-06-14,NA,0,0,1
19445,13512,13352,46309,2013-06-15,NA,0,1,1
17574,12677,9439,39690,2013-06-16,"Cultural",0,0,0
15253,10240,8625,34118,2013-06-17,NA,0,0,0
14223,9217,7737,31177,2013-06-18,NA,0,0,0
14013,9232,7825,31070,2013-06-19,NA,0,0,0
14452,9200,8119,31771,2013-06-20,"Sporting",0,0,0
16679,10458,9566,36703,2013-06-21,NA,0,0,0
19032,12805,10439,42276,2013-06-22,NA,0,0,0
19972,13266,10037,43275,2013-06-23,NA,0,0,0
15516,10380,8222,34118,2013-06-24,NA,0,0,0
14620,9245,7738,31603,2013-06-25,NA,0,0,0
13896,9023,7437,30356,2013-06-26,NA,0,0,0
14578,9134,7745,31457,2013-06-27,NA,0,0,0
17612,10353,8788,36753,2013-06-28,NA,0,0,0
21364,12756,10829,44949,2013-06-29,NA,0,0,0
21044,13539,10240,44823,2013-06-30,NA,0,0,0
18300,11497,8919,38716,2013-07-01,NA,1,1,0
17705,9548,9989,37242,2013-07-02,NA,1,0,1
19894,11644,12461,43999,2013-07-03,NA,1,1,1
17287,11248,8248,36783,2013-07-04,"National",1,0,0
18124,11684,10999,40807,2013-07-05,NA,1,1,1
17843,12766,11223,41832,2013-07-06,NA,1,1,1
20695,13357,10572,44624,2013-07-07,NA,1,1,0
16475,10126,10859,37460,2013-07-08,NA,1,0,1
16104,10405,10744,37253,2013-07-09,"Religious",1,1,1
16039,9084,9456,34579,2013-07-10,NA,1,0,0
14923,10818,10620,36361,2013-07-11,NA,0,1,1
16907,12245,12127,41279,2013-07-12,NA,0,1,1
19047,14227,11911,45185,2013-07-13,NA,0,1,0
20294,13436,12942,46672,2013-07-14,NA,0,0,1
15533,11083,11008,37624,2013-07-15,NA,0,1,1
14502,9368,10067,33937,2013-07-16,NA,0,0,0
14508,9028,8931,32467,2013-07-17,NA,0,0,0
14971,9740,9210,33921,2013-07-18,NA,0,0,0
16383,9908,9903,36194,2013-07-19,NA,0,0,0
19732,11521,10274,41527,2013-07-20,NA,0,0,0
20560,12539,8940,42039,2013-07-21,NA,0,0,0
14781,9634,7788,32203,2013-07-22,NA,0,0,0
14590,9420,7294,31304,2013-07-23,NA,0,0,0
14347,9662,7459,31468,2013-07-24,NA,0,0,0
15007,9197,7612,31816,2013-07-25,NA,0,0,0
16352,10769,9722,36843,2013-07-26,NA,0,0,0
19286,12360,10026,41672,2013-07-27,NA,0,0,0
19053,12670,8757,40480,2013-07-28,NA,0,0,0
15122,9875,6766,31763,2013-07-29,NA,0,0,0
14093,8944,7125,30162,2013-07-30,NA,0,0,0
14441,8844,7970,31255,2013-07-31,NA,0,0,0
16662,11741,8906,37309,2013-08-01,NA,1,1,0
17874,11721,12068,41663,2013-08-02,NA,1,0,1
20462,13599,13044,47105,2013-08-03,NA,1,1,1
20439,13544,10456,44439,2013-08-04,NA,1,0,0
17120,11628,10401,39149,2013-08-05,NA,1,1,1
15295,10959,10440,36694,2013-08-06,NA,1,1,1
15716,10898,8465,35079,2013-08-07,NA,1,1,0
15548,9665,9673,34886,2013-08-08,"Religious",1,0,1
17285,12564,10850,40699,2013-08-09,NA,1,1,1
21051,12952,10909,44912,2013-08-10,NA,1,0,0
20776,14761,11983,47520,2013-08-11,NA,0,1,1
16617,11232,10904,38753,2013-08-12,NA,0,1,1
14938,11444,8762,35144,2013-08-13,NA,0,1,0
14879,8876,9977,33732,2013-08-14,NA,0,0,1
15213,10974,11456,37643,2013-08-15,NA,0,1,1
16785,9888,11352,38025,2013-08-16,NA,0,0,0
20418,12856,11157,44431,2013-08-17,NA,0,0,0
20883,13267,10744,44894,2013-08-18,NA,0,0,0
16562,10130,8545,35237,2013-08-19,NA,0,0,0
14879,8910,7836,31625,2013-08-20,NA,0,0,0
14871,9440,8322,32633,2013-08-21,NA,0,0,0
14577,9348,7868,31793,2013-08-22,NA,0,0,0
16665,11295,9153,37113,2013-08-23,NA,0,0,0
20575,13847,10414,44836,2013-08-24,NA,0,0,0
23275,14357,10945,48577,2013-08-25,NA,0,0,0
15435,9839,8926,34200,2013-08-26,NA,0,0,0
14572,9332,9059,32963,2013-08-27,NA,0,0,0
14381,9494,8581,32456,2013-08-28,NA,0,0,0
14521,8676,8513,31710,2013-08-29,NA,0,0,0
18431,11093,12097,41621,2013-08-30,NA,0,0,0
21995,13843,12134,47972,2013-08-31,NA,0,0,0
20502,14101,10138,44741,2013-09-01,NA,1,1,0
21384,13152,12536,47072,2013-09-02,"National",1,0,1
16093,10718,10988,37799,2013-09-03,NA,1,1,1
14916,9290,9122,33328,2013-09-04,NA,1,0,0
15153,10489,9783,35425,2013-09-05,NA,1,1,1
17050,10725,10909,38684,2013-09-06,NA,1,1,1
21435,14426,11739,47600,2013-09-07,NA,1,1,0
23603,14880,13257,51740,2013-09-08,NA,1,0,1
17616,11075,11074,39765,2013-09-09,NA,1,1,1
16409,8993,9261,34663,2013-09-10,NA,1,0,0
15382,10173,10640,36195,2013-09-11,NA,0,1,1
15063,10484,11220,36767,2013-09-12,NA,0,1,1
17151,12449,11371,40971,2013-09-13,NA,0,1,0
20484,14457,14225,49166,2013-09-14,NA,0,0,1
21880,15151,13939,50970,2013-09-15,NA,0,1,1
16589,10591,9595,36775,2013-09-16,NA,0,0,0
14832,9327,8412,32571,2013-09-17,NA,0,0,0
14112,9216,7953,31281,2013-09-18,NA,0,0,0
14148,8889,7786,30823,2013-09-19,NA,0,0,0
16931,9211,10139,36281,2013-09-20,NA,0,0,0
20954,13422,11625,46001,2013-09-21,NA,0,0,0
21819,13522,10869,46210,2013-09-22,NA,0,0,0
15148,9423,8213,32784,2013-09-23,NA,0,0,0
14694,8830,7540,31064,2013-09-24,NA,0,0,0
13355,8732,7872,29959,2013-09-25,NA,0,0,0
14062,8652,7934,30648,2013-09-26,NA,0,0,0
15618,10047,9837,35502,2013-09-27,NA,0,0,0
19821,12909,11711,44441,2013-09-28,NA,0,0,0
20788,12740,10868,44396,2013-09-29,NA,0,0,0
15385,9074,8434,32893,2013-09-30,NA,0,0,0
15717,11206,9807,36730,2013-10-01,NA,1,1,0
14460,9063,10377,33900,2013-10-02,NA,1,0,1
15034,10635,11546,37215,2013-10-03,NA,1,1,1
17030,10061,10243,37334,2013-10-04,NA,1,0,0
21356,13640,13781,48777,2013-10-05,NA,1,1,1
22045,14668,13175,49888,2013-10-06,NA,1,1,1
16759,11000,9244,37003,2013-10-07,NA,1,1,0
15637,9239,9668,34544,2013-10-08,NA,1,0,1
15008,9437,10301,34746,2013-10-09,NA,1,1,1
16033,8925,9061,34019,2013-10-10,NA,1,0,0
16112,10626,11355,38093,2013-10-11,NA,0,1,1
19520,12558,14503,46581,2013-10-12,NA,0,1,1
20465,14064,11814,46343,2013-10-13,NA,0,1,0
15592,10831,10413,36836,2013-10-14,"National",0,0,1
13731,9681,9801,33213,2013-10-15,"Religious",0,1,1
13987,9319,9371,32677,2013-10-16,NA,0,0,0
13966,8411,8161,30538,2013-10-17,NA,0,0,0
15615,9141,9581,34337,2013-10-18,NA,0,0,0
19048,12055,10940,42043,2013-10-19,NA,0,0,0
20688,12170,10494,43352,2013-10-20,NA,0,0,0
14762,9342,7755,31859,2013-10-21,NA,0,0,0
13558,8128,7271,28957,2013-10-22,NA,0,0,0
13032,8545,7948,29525,2013-10-23,NA,0,0,0
13066,8311,7883,29260,2013-10-24,NA,0,0,0
14957,9144,9776,33877,2013-10-25,NA,0,0,0
19043,11526,11885,42454,2013-10-26,NA,0,0,0
19459,12213,8993,40665,2013-10-27,NA,0,0,0
15149,9371,7538,32058,2013-10-28,NA,0,0,0
13780,8009,7740,29529,2013-10-29,NA,0,0,0
15458,8629,7049,31136,2013-10-30,NA,0,0,0
11722,7625,7687,27034,2013-10-31,"Cultural",0,0,0
16539,11501,11687,39727,2013-11-01,NA,1,1,0
20526,12328,14239,47093,2013-11-02,NA,1,0,1
21495,13166,13712,48373,2013-11-03,NA,1,1,1
15376,9045,8551,32972,2013-11-04,NA,1,0,0
14683,9850,9554,34087,2013-11-05,NA,1,1,1
14152,9143,9735,33030,2013-11-06,NA,1,1,1
13890,9482,8581,31953,2013-11-07,NA,1,1,0
15340,9143,10977,35460,2013-11-08,NA,1,0,1
19643,11819,14255,45717,2013-11-09,NA,1,1,1
20105,12183,11617,43905,2013-11-10,NA,1,0,0
16490,10360,9546,36396,2013-11-11,"National",0,1,1
12770,9517,9988,32275,2013-11-12,NA,0,1,1
12613,8526,8116,29255,2013-11-13,NA,0,1,0
12551,7933,8984,29468,2013-11-14,NA,0,0,1
14870,9989,10916,35775,2013-11-15,NA,0,1,1
19340,12556,12691,44587,2013-11-16,NA,0,0,0
19731,12678,10180,42589,2013-11-17,NA,0,0,0
14428,8938,8744,32110,2013-11-18,NA,0,0,0
12299,8195,8028,28522,2013-11-19,NA,0,0,0
11884,8042,7989,27915,2013-11-20,NA,0,0,0
12375,8055,8269,28699,2013-11-21,NA,0,0,0
14280,8741,9842,32863,2013-11-22,NA,0,0,0
18472,10351,11224,40047,2013-11-23,NA,0,0,0
18198,10810,9438,38446,2013-11-24,NA,0,0,0
13854,7355,7436,28645,2013-11-25,NA,0,0,0
14129,8884,8280,31293,2013-11-26,NA,0,0,0
15079,10922,10138,36139,2013-11-27,NA,0,0,0
8302,6489,5048,19839,2013-11-28,"National",0,0,0
10763,7126,8184,26073,2013-11-29,NA,0,0,0
13572,8388,9586,31546,2013-11-30,NA,0,0,0
16983,10626,10578,38187,2013-12-01,NA,1,1,0
16466,9609,11012,37087,2013-12-02,NA,1,0,1
15949,10508,11567,38024,2013-12-03,NA,1,1,1
13865,8570,9084,31519,2013-12-04,NA,1,0,0
14368,9612,11171,35151,2013-12-05,"Religious",1,1,1
15616,9818,11465,36899,2013-12-06,NA,1,1,1
19874,12366,12210,44450,2013-12-07,NA,1,1,0
18772,11556,10096,40424,2013-12-08,NA,1,0,1
14829,8855,9969,33653,2013-12-09,NA,1,1,1
14720,8370,8332,31422,2013-12-10,NA,1,0,0
12882,8642,9387,30911,2013-12-11,NA,0,1,1
12353,8769,10547,31669,2013-12-12,NA,0,1,1
14678,9389,12096,36163,2013-12-13,NA,0,1,0
18160,11203,12165,41528,2013-12-14,NA,0,0,1
17943,12422,12732,43097,2013-12-15,NA,0,1,1
14530,9333,8611,32474,2013-12-16,NA,0,0,0
13153,8638,8547,30338,2013-12-17,NA,0,0,0
13387,9549,8756,31692,2013-12-18,NA,0,0,0
13290,10179,8942,32411,2013-12-19,NA,0,0,0
13776,9054,9293,32123,2013-12-20,NA,0,0,0
17676,9930,12868,40474,2013-12-21,NA,0,0,0
17748,10424,6743,34915,2013-12-22,NA,0,0,0
15786,9489,10014,35289,2013-12-23,NA,0,0,0
12607,8888,9582,31077,2013-12-24,NA,0,0,0
5,13,2,20,2013-12-25,"National",0,0,0
14544,9739,8444,32727,2013-12-26,NA,0,0,0
14677,9262,9156,33095,2013-12-27,NA,0,0,0
15846,10454,10190,36490,2013-12-28,NA,0,0,0
15455,9983,8683,34121,2013-12-29,NA,0,0,0
15159,8975,8159,32293,2013-12-30,NA,0,0,0
14973,9789,10049,34811,2013-12-31,NA,0,0,0
10884,7837,5124,23845,2014-01-01,"National",1,1,0
14703,8647,9303,32653,2014-01-02,NA,1,0,1
15982,10147,12741,38870,2014-01-03,NA,1,1,1
17993,11291,15332,44616,2014-01-04,NA,1,0,0
19258,12592,13452,45302,2014-01-05,NA,1,1,1
15562,9616,7234,32412,2014-01-06,NA,1,1,1
14199,9289,7464,30952,2014-01-07,"Religious",1,1,0
13953,8760,10260,32973,2014-01-08,NA,1,0,1
13308,9046,10843,33197,2014-01-09,NA,1,1,1
15094,8404,9268,32766,2014-01-10,NA,1,0,0
20084,12676,15038,47798,2014-01-11,NA,0,1,1
19062,13028,14768,46858,2014-01-12,NA,0,1,1
14826,10226,8662,33714,2014-01-13,NA,0,1,0
12483,8390,9350,30223,2014-01-14,NA,0,0,1
13118,8649,9812,31579,2014-01-15,NA,0,1,1
13275,8290,9625,31190,2014-01-16,NA,0,0,0
15801,8810,10629,35240,2014-01-17,NA,0,0,0
20056,10339,12838,43233,2014-01-18,NA,0,0,0
17807,11231,11389,40427,2014-01-19,NA,0,0,0
15452,9189,8065,32706,2014-01-20,"National",0,0,0
12793,7404,7657,27854,2014-01-21,NA,0,0,0
13228,7567,7402,28197,2014-01-22,NA,0,0,0
12047,7212,6985,26244,2014-01-23,NA,0,0,0
14269,7669,8950,30888,2014-01-24,NA,0,0,0
18248,10581,11700,40529,2014-01-25,NA,0,0,0
19371,10811,10015,40197,2014-01-26,NA,0,0,0
13512,9848,6700,30060,2014-01-27,NA,0,0,0
12167,5634,6199,24000,2014-01-28,NA,0,0,0
10941,6774,7268,24983,2014-01-29,NA,0,0,0
11714,7442,7861,27017,2014-01-30,NA,0,0,0
14942,9334,12213,36489,2014-01-31,NA,0,0,0
20480,12629,12224,45333,2014-02-01,NA,1,1,0
19300,11121,13476,43897,2014-02-02,"Sporting",1,0,1
15947,9288,12059,37294,2014-02-03,NA,1,1,1
13963,7692,8922,30577,2014-02-04,NA,1,0,0
13759,8412,9505,31676,2014-02-05,NA,1,1,1
13845,8352,10192,32389,2014-02-06,NA,1,1,1
14641,9671,9943,34255,2014-02-07,NA,1,1,0
21851,11365,13892,47108,2014-02-08,NA,1,0,1
21126,13388,13526,48040,2014-02-09,NA,1,1,1
15714,8654,8779,33147,2014-02-10,NA,1,0,0
13694,9350,10489,33533,2014-02-11,NA,0,1,1
13889,11094,11755,36738,2014-02-12,NA,0,1,1
15294,11744,10445,37483,2014-02-13,NA,0,1,0
13393,9663,10854,33910,2014-02-14,"Cultural",0,0,1
17799,12726,14440,44965,2014-02-15,NA,0,1,1
17962,12794,13076,43832,2014-02-16,NA,0,0,0
15790,11467,7300,34557,2014-02-17,"National",0,0,0
12719,8556,9435,30710,2014-02-18,NA,0,0,0
12495,8225,9691,30411,2014-02-19,NA,0,0,0
13149,8224,8330,29703,2014-02-20,NA,0,0,0
14070,9316,9940,33326,2014-02-21,NA,0,0,0
17686,10868,12934,41488,2014-02-22,NA,0,0,0
18909,13334,12184,44427,2014-02-23,NA,0,0,0
13794,9228,8775,31797,2014-02-24,NA,0,0,0
13035,8545,8145,29725,2014-02-25,NA,0,0,0
11294,7169,7888,26351,2014-02-26,NA,0,0,0
12578,8424,7888,28890,2014-02-27,NA,0,0,0
13154,9814,11230,34198,2014-02-28,NA,0,0,0
20981,12257,12258,45496,2014-03-01,NA,1,1,0
20852,12206,13719,46777,2014-03-02,NA,1,0,1
15203,10261,11737,37201,2014-03-03,NA,1,1,1
13650,7653,8763,30066,2014-03-04,NA,1,0,0
12396,9265,9617,31278,2014-03-05,"Religious",1,1,1
12840,9479,10343,32662,2014-03-06,NA,1,1,1
14643,9895,10326,34864,2014-03-07,NA,1,1,0
17971,11665,13849,43485,2014-03-08,NA,1,0,1
21869,14175,14046,50090,2014-03-09,NA,1,1,1
16430,10904,10172,37506,2014-03-10,NA,1,0,0
13918,10051,10598,34567,2014-03-11,NA,0,1,1
13981,10449,10512,34942,2014-03-12,"Religious",0,1,1
13680,10291,9113,33084,2014-03-13,NA,0,1,0
15179,10111,11656,36946,2014-03-14,NA,0,0,1
19039,12071,13598,44708,2014-03-15,NA,0,1,1
20018,13285,12073,45376,2014-03-16,"Religious",0,0,0
14273,9712,8099,32084,2014-03-17,"Cultural",0,0,0
13161,8811,8123,30095,2014-03-18,NA,0,0,0
12693,8833,7858,29384,2014-03-19,NA,0,0,0
12703,8365,7741,28809,2014-03-20,NA,0,0,0
14720,9385,9097,33202,2014-03-21,NA,0,0,0
18616,11015,11810,41441,2014-03-22,NA,0,0,0
20673,12219,11279,44171,2014-03-23,NA,0,0,0
14672,9314,7857,31843,2014-03-24,NA,0,0,0
12983,8402,7081,28466,2014-03-25,NA,0,0,0
12742,6296,7976,27014,2014-03-26,NA,0,0,0
13134,9431,7645,30210,2014-03-27,NA,0,0,0
14684,8596,9638,32918,2014-03-28,NA,0,0,0
17862,11015,12316,41193,2014-03-29,NA,0,0,0
20499,12109,10548,43156,2014-03-30,NA,0,0,0
13605,9506,7561,30672,2014-03-31,NA,0,0,0
14505,10208,8995,33708,2014-04-01,NA,1,1,0
14744,8515,10440,33699,2014-04-02,NA,1,0,1
15363,9821,11420,36604,2014-04-03,NA,1,1,1
15875,9808,10002,35685,2014-04-04,NA,1,0,0
20477,12347,13952,46776,2014-04-05,NA,1,1,1
21710,13459,13621,48790,2014-04-06,NA,1,1,1
17070,10570,8954,36594,2014-04-07,NA,1,1,0
16152,8860,10236,35248,2014-04-08,NA,1,0,1
15555,9346,10308,35209,2014-04-09,NA,1,1,1
15227,9202,8609,33038,2014-04-10,NA,1,0,0
16110,10900,11429,38439,2014-04-11,NA,0,1,1
18790,12830,14535,46155,2014-04-12,NA,0,1,1
20183,14517,11383,46083,2014-04-13,NA,0,1,0
15012,9664,11075,35751,2014-04-14,NA,0,0,1
14174,11157,11065,36396,2014-04-15,NA,0,1,1
14716,9984,9528,34228,2014-04-16,NA,0,0,0
14652,9374,9167,33193,2014-04-17,NA,0,0,0
16814,11668,10423,38905,2014-04-18,NA,0,0,0
21794,13231,12794,47819,2014-04-19,NA,0,0,0
18353,12553,8028,38934,2014-04-20,"Cultural",0,0,0
14419,9293,7914,31626,2014-04-21,NA,0,0,0
14025,9186,7467,30678,2014-04-22,"Religious",0,0,0
13630,8931,7876,30437,2014-04-23,NA,0,0,0
13940,9059,7793,30792,2014-04-24,NA,0,0,0
14391,9859,9177,33427,2014-04-25,NA,0,0,0
19037,11752,11588,42377,2014-04-26,NA,0,0,0
20454,12371,10615,43440,2014-04-27,NA,0,0,0
14501,9803,7204,31508,2014-04-28,NA,0,0,0
13390,8473,8002,29865,2014-04-29,NA,0,0,0
13130,8180,7573,28883,2014-04-30,NA,0,0,0
15529,9613,8717,33859,2014-05-01,NA,1,1,0
17526,9785,11640,38951,2014-05-02,NA,1,0,1
20320,12750,13472,46542,2014-05-03,NA,1,1,1
20749,12721,11669,45139,2014-05-04,NA,1,0,0
16144,10193,9483,35820,2014-05-05,"Cultural",1,1,1
14777,9793,9041,33611,2014-05-06,NA,1,1,1
14104,9946,8096,32146,2014-05-07,NA,1,1,0
14204,8270,9345,31819,2014-05-08,NA,1,0,1
15828,9628,10907,36363,2014-05-09,NA,1,1,1
18744,11929,12170,42843,2014-05-10,NA,1,0,0
16920,11763,9497,38180,2014-05-11,"Cultural",0,1,1
16283,10462,11177,37922,2014-05-12,NA,0,1,1
14959,9361,9524,33844,2014-05-13,NA,0,1,0
14079,8271,10467,32817,2014-05-14,NA,0,0,1
14051,9487,9984,33522,2014-05-15,NA,0,1,1
15216,9589,9784,34589,2014-05-16,NA,0,0,0
17770,10745,11504,40019,2014-05-17,NA,0,0,0
19798,12388,10834,43020,2014-05-18,NA,0,0,0
15056,9257,8001,32314,2014-05-19,NA,0,0,0
13394,8724,7808,29926,2014-05-20,NA,0,0,0
12930,8487,7666,29083,2014-05-21,NA,0,0,0
13417,8693,8276,30386,2014-05-22,NA,0,0,0
14824,9251,9350,33425,2014-05-23,NA,0,0,0
16951,11174,10261,38386,2014-05-24,NA,0,0,0
16360,10910,8695,35965,2014-05-25,NA,0,0,0
16291,9167,8001,33459,2014-05-26,"National",0,0,0
14005,7652,7255,28912,2014-05-27,NA,0,0,0
12549,8117,7443,28109,2014-05-28,NA,0,0,0
12276,8064,7349,27689,2014-05-29,NA,0,0,0
14309,9816,9615,33740,2014-05-30,NA,0,0,0
18204,11220,11268,40692,2014-05-31,NA,0,0,0
20472,13215,10915,44602,2014-06-01,NA,1,1,0
16617,10022,10673,37312,2014-06-02,NA,1,0,1
15777,10319,12261,38357,2014-06-03,NA,1,1,1
14823,9038,9038,32899,2014-06-04,NA,1,0,0
15072,10599,9984,35655,2014-06-05,"Sporting",1,1,1
15825,10304,11328,37457,2014-06-06,NA,1,1,1
19146,13562,11639,44347,2014-06-07,NA,1,1,0
19946,12848,12485,45279,2014-06-08,NA,1,0,1
17306,10082,10868,38256,2014-06-09,NA,1,1,1
15188,9221,9249,33658,2014-06-10,NA,1,0,0
14796,10173,9675,34644,2014-06-11,NA,0,1,1
14461,9957,10659,35077,2014-06-12,NA,0,1,1
16308,11609,10439,38356,2014-06-13,NA,0,1,0
19564,12989,12431,44984,2014-06-14,NA,0,0,1
17497,12908,12089,42494,2014-06-15,"Sporting",0,1,1
15312,10574,9317,35203,2014-06-16,NA,0,0,0
14678,9445,9419,33542,2014-06-17,NA,0,0,0
14835,8956,8478,32269,2014-06-18,NA,0,0,0
14750,9704,8666,33120,2014-06-19,NA,0,0,0
16980,10646,10370,37996,2014-06-20,NA,0,0,0
19216,12241,10963,42420,2014-06-21,NA,0,0,0
19882,12386,10192,42460,2014-06-22,NA,0,0,0
15294,9271,8593,33158,2014-06-23,NA,0,0,0
14323,8416,7902,30641,2014-06-24,NA,0,0,0
13219,8097,7505,28821,2014-06-25,NA,0,0,0
13530,8305,7521,29356,2014-06-26,NA,0,0,0
15378,9586,9114,34078,2014-06-27,NA,0,0,0
18671,10959,10300,39930,2014-06-28,NA,0,0,0
18929,11258,10024,40211,2014-06-29,"Religious",0,0,0
15686,9540,8223,33449,2014-06-30,NA,0,0,0
16770,11118,9851,37739,2014-07-01,NA,1,1,0
16289,9651,11929,37869,2014-07-02,NA,1,0,1
20128,13209,13691,47028,2014-07-03,NA,1,1,1
16997,11912,9684,38593,2014-07-04,"National",1,0,0
17756,11458,11568,40782,2014-07-05,NA,1,1,1
20262,12870,12358,45490,2014-07-06,NA,1,1,1
17119,11382,9134,37635,2014-07-07,NA,1,1,0
16206,9298,10944,36448,2014-07-08,NA,1,0,1
15257,10827,11130,37214,2014-07-09,NA,1,1,1
16491,9653,9035,35179,2014-07-10,NA,1,0,0
16756,11569,11928,40253,2014-07-11,NA,0,1,1
19613,14084,13999,47696,2014-07-12,NA,0,1,1
19244,13098,11333,43675,2014-07-13,NA,0,1,0
15330,10118,10833,36281,2014-07-14,NA,0,0,1
14994,10154,10667,35815,2014-07-15,NA,0,1,1
14533,9576,8902,33011,2014-07-16,NA,0,0,0
14157,9184,9089,32430,2014-07-17,NA,0,0,0
16302,9925,10222,36449,2014-07-18,NA,0,0,0
18827,12202,11451,42480,2014-07-19,NA,0,0,0
19725,12309,10655,42689,2014-07-20,NA,0,0,0
15208,9775,8468,33451,2014-07-21,NA,0,0,0
13945,9201,8366,31512,2014-07-22,NA,0,0,0
14240,8882,7817,30939,2014-07-23,NA,0,0,0
14214,8473,7838,30525,2014-07-24,NA,0,0,0
15269,9807,8772,33848,2014-07-25,NA,0,0,0
17776,10663,10569,39008,2014-07-26,NA,0,0,0
20037,12348,9829,42214,2014-07-27,NA,0,0,0
15315,9558,7759,32632,2014-07-28,NA,0,0,0
14014,8732,7959,30705,2014-07-29,"Religious",0,0,0
13916,8857,7561,30334,2014-07-30,NA,0,0,0
14501,8927,8412,31840,2014-07-31,NA,0,0,0
18047,12993,12089,43129,2014-08-01,NA,1,1,0
19978,12610,14423,47011,2014-08-02,NA,1,0,1
21352,12974,13246,47572,2014-08-03,NA,1,1,1
16516,10139,9144,35799,2014-08-04,NA,1,0,0
15724,10208,10306,36238,2014-08-05,NA,1,1,1
15077,9353,10117,34547,2014-08-06,NA,1,1,1
15574,10175,8828,34577,2014-08-07,NA,1,1,0
16822,11208,10950,38980,2014-08-08,NA,1,0,1
20235,12170,12853,45258,2014-08-09,NA,1,1,1
20759,11607,10883,43249,2014-08-10,NA,1,0,0
15419,10381,10322,36122,2014-08-11,NA,0,1,1
15041,10035,11596,36672,2014-08-12,NA,0,1,1
14576,10380,9463,34419,2014-08-13,NA,0,1,0
14444,9619,10473,34536,2014-08-14,NA,0,0,1
15332,11024,11902,38258,2014-08-15,NA,0,1,1
19421,12542,12592,44555,2014-08-16,NA,0,0,0
21639,13221,11813,46673,2014-08-17,NA,0,0,0
16581,9851,8947,35379,2014-08-18,NA,0,0,0
14344,9200,8415,31959,2014-08-19,NA,0,0,0
13973,8931,8943,31847,2014-08-20,NA,0,0,0
14062,9691,8646,32399,2014-08-21,NA,0,0,0
16320,10897,9899,37116,2014-08-22,NA,0,0,0
20126,13257,11290,44673,2014-08-23,NA,0,0,0
21876,14391,11176,47443,2014-08-24,NA,0,0,0
15022,10727,8918,34667,2014-08-25,NA,0,0,0
13881,9367,8154,31402,2014-08-26,NA,0,0,0
13182,8281,8043,29506,2014-08-27,NA,0,0,0
13328,8527,8121,29976,2014-08-28,NA,0,0,0
15871,9444,12378,37693,2014-08-29,NA,0,0,0
18717,12075,12445,43237,2014-08-30,NA,0,0,0
17656,10625,10929,39210,2014-08-31,NA,0,0,0
19179,12686,11391,43256,2014-09-01,"National",1,1,0
15047,8789,10463,34299,2014-09-02,NA,1,0,1
15352,10162,11883,37397,2014-09-03,NA,1,1,1
14157,8325,9001,31483,2014-09-04,NA,1,0,0
15262,9556,11148,35966,2014-09-05,NA,1,1,1
19408,12703,13906,46017,2014-09-06,NA,1,1,1
21338,12606,12009,45953,2014-09-07,NA,1,1,0
15427,10232,9921,35580,2014-09-08,NA,1,0,1
14425,9441,10301,34167,2014-09-09,NA,1,1,1
14479,8743,8570,31792,2014-09-10,NA,1,0,0
14355,10001,10124,34480,2014-09-11,NA,0,1,1
16653,10153,11553,38359,2014-09-12,NA,0,1,1
20184,13984,13411,47579,2014-09-13,NA,0,1,0
20240,12757,12750,45747,2014-09-14,NA,0,0,1
15711,10331,10517,36559,2014-09-15,NA,0,1,1
14076,8613,8348,31037,2014-09-16,NA,0,0,0
13966,8166,7699,29831,2014-09-17,NA,0,0,0
13430,7307,8124,28861,2014-09-18,NA,0,0,0
15605,10025,9202,34832,2014-09-19,NA,0,0,0
19738,11877,11417,43032,2014-09-20,NA,0,0,0
20735,12979,10688,44402,2014-09-21,NA,0,0,0
14751,9006,7753,31510,2014-09-22,NA,0,0,0
13968,8261,7181,29410,2014-09-23,NA,0,0,0
13356,8051,7594,29001,2014-09-24,NA,0,0,0
13472,8108,7931,29511,2014-09-25,NA,0,0,0
14940,8899,9288,33127,2014-09-26,NA,0,0,0
18447,11013,11379,40839,2014-09-27,NA,0,0,0
19691,12187,11046,42924,2014-09-28,NA,0,0,0
14958,8749,7766,31473,2014-09-29,NA,0,0,0
13841,7910,8239,29990,2014-09-30,NA,0,0,0
14894,10034,9674,34602,2014-10-01,NA,1,1,0
14865,9135,10249,34249,2014-10-02,NA,1,0,1
17105,11644,13087,41836,2014-10-03,NA,1,1,1
21225,12396,13578,47199,2014-10-04,"Religious",1,0,0
21661,13206,13494,48361,2014-10-05,NA,1,1,1
17144,9870,10705,37719,2014-10-06,NA,1,1,1
14492,10014,8645,33151,2014-10-07,NA,1,1,0
14381,8733,10071,33185,2014-10-08,NA,1,0,1
14092,9361,10285,33738,2014-10-09,NA,1,1,1
15377,9333,10291,35001,2014-10-10,NA,1,0,0
18742,12354,13465,44561,2014-10-11,NA,0,1,1
19652,13039,14044,46735,2014-10-12,NA,0,1,1
15008,10122,8427,33557,2014-10-13,"National",0,1,0
13134,8739,10578,32451,2014-10-14,NA,0,0,1
13265,9757,11171,34193,2014-10-15,NA,0,1,1
12232,8333,9371,29936,2014-10-16,NA,0,0,0
14735,9032,9663,33430,2014-10-17,NA,0,0,0
19310,11852,12593,43755,2014-10-18,NA,0,0,0
20322,12096,11038,43456,2014-10-19,NA,0,0,0
14931,9309,7993,32233,2014-10-20,NA,0,0,0
13419,7966,7982,29367,2014-10-21,NA,0,0,0
12215,8015,7696,27926,2014-10-22,NA,0,0,0
12800,7845,7861,28506,2014-10-23,NA,0,0,0
13962,8842,9986,32790,2014-10-24,NA,0,0,0
18415,10461,11877,40753,2014-10-25,NA,0,0,0
18317,11841,10039,40197,2014-10-26,NA,0,0,0
14486,8899,7818,31203,2014-10-27,NA,0,0,0
12591,8105,7644,28340,2014-10-28,NA,0,0,0
12545,7721,7297,27563,2014-10-29,NA,0,0,0
13818,8659,7758,30235,2014-10-30,NA,0,0,0
13024,9411,10415,32850,2014-10-31,"Cultural",0,0,0
20253,11685,12311,44249,2014-11-01,NA,1,1,0
21092,11490,13490,46072,2014-11-02,NA,1,0,1
16462,10265,11837,38564,2014-11-03,NA,1,1,1
14001,8524,9427,31952,2014-11-04,NA,1,0,0
13264,7946,9622,30832,2014-11-05,NA,1,1,1
13878,9085,10260,33223,2014-11-06,NA,1,1,1
15019,9969,9775,34763,2014-11-07,NA,1,1,0
19284,11053,13933,44270,2014-11-08,NA,1,0,1
20404,13193,13818,47415,2014-11-09,NA,1,1,1
16116,9609,8724,34449,2014-11-10,NA,1,0,0
14501,8797,9290,32588,2014-11-11,"National",0,1,1
11966,8281,10243,30490,2014-11-12,NA,0,1,1
11992,8476,8243,28711,2014-11-13,NA,0,1,0
13994,9195,11550,34739,2014-11-14,NA,0,0,1
17879,11929,14575,44383,2014-11-15,NA,0,1,1
19201,12187,12128,43516,2014-11-16,NA,0,0,0
14039,9076,8696,31811,2014-11-17,NA,0,0,0
12619,7963,7432,28014,2014-11-18,NA,0,0,0
11988,8025,8034,28047,2014-11-19,NA,0,0,0
11993,8283,7971,28247,2014-11-20,NA,0,0,0
14421,8398,10044,32863,2014-11-21,NA,0,0,0
19145,11482,11775,42402,2014-11-22,NA,0,0,0
18717,11606,10307,40630,2014-11-23,NA,0,0,0
14628,9462,7508,31598,2014-11-24,NA,0,0,0
14751,8894,8243,31888,2014-11-25,NA,0,0,0
15812,10727,10364,36903,2014-11-26,NA,0,0,0
8930,7672,5242,21844,2014-11-27,"National",0,0,0
11524,7587,7243,26354,2014-11-28,NA,0,0,0
15234,9176,10046,34456,2014-11-29,NA,0,0,0
16322,10206,9277,35805,2014-11-30,NA,0,0,0
15515,9557,9233,34305,2014-12-01,NA,1,1,0
12665,8227,9677,30569,2014-12-02,NA,1,0,1
12590,9036,10979,32605,2014-12-03,NA,1,1,1
14778,7583,9155,31516,2014-12-04,NA,1,0,0
15097,9677,12189,36963,2014-12-05,NA,1,1,1
19085,11579,13151,43815,2014-12-06,NA,1,1,1
18773,12409,11345,42527,2014-12-07,NA,1,1,0
14487,9013,9614,33114,2014-12-08,NA,1,0,1
14319,8872,9476,32667,2014-12-09,NA,1,1,1
15526,7899,8473,31898,2014-12-10,NA,1,0,0
8585,8161,9369,26115,2014-12-11,NA,0,1,1
13448,9314,10740,33502,2014-12-12,NA,0,1,1
17179,11203,11654,40036,2014-12-13,NA,0,1,0
17834,12014,12158,42006,2014-12-14,NA,0,0,1
12986,10762,10379,34127,2014-12-15,NA,0,1,1
12272,9121,8543,29936,2014-12-16,NA,0,0,0
12716,9384,8052,30152,2014-12-17,NA,0,0,0
13501,10029,8837,32367,2014-12-18,NA,0,0,0
12432,8226,9176,29834,2014-12-19,NA,0,0,0
16757,10739,10925,38421,2014-12-20,NA,0,0,0
17815,10749,9924,38488,2014-12-21,NA,0,0,0
15575,9510,8651,33736,2014-12-22,NA,0,0,0
15172,9724,9966,34862,2014-12-23,NA,0,0,0
11485,9084,9048,29617,2014-12-24,"Religious",0,0,0
6,13,1,20,2014-12-25,"National",0,0,0
13329,10507,9073,32909,2014-12-26,NA,0,0,0
14550,9037,9007,32594,2014-12-27,NA,0,0,0
15122,8475,8297,31894,2014-12-28,NA,0,0,0
13406,9043,7541,29990,2014-12-29,NA,0,0,0
12385,8981,8051,29417,2014-12-30,NA,0,0,0
13248,9329,10873,33450,2014-12-31,NA,0,0,0
